68 7a 1f 40 00 48 c7 c7
68 66 60 55 c3 00 00 00 
00 00 00 00 00 00 00 00
00 00 00 00 00 00 00 00
00 00 00 00 00 00 00 00
00 00 00 00 00 00 00 00
00 00 00 00 00 00 00 00
28 66 60 55 00 00 00 00
35 32 61 32 64 61 33 37
00
