00 00 00 00 00 00 00 00
00 00 00 00 00 00 00 00
00 00 00 00 00 00 00 00
00 00 00 00 00 00 00 00
00 00 00 00 00 00 00 00
00 00 00 00 00 00 00 00
00 00 00 00 00 00 00 00
ad 20 40 00 00 00 00 00
45 20 40 00 00 00 00 00
30 20 40 00 00 00 00 00
48 00 00 00 00 00 00 00
2a 21 40 00 00 00 00 00
15 21 40 00 00 00 00 00
80 21 40 00 00 00 00 00
8a 20 40 00 00 00 00 00
45 20 40 00 00 00 00 00
7a 1f 40 00 00 00 00 00
35 32 61 32 64 61 33 37
00
